SSSSSSSSSSSSSSSSSSSSSSSSSSSSSS
SSSSSSSSSSLLLLLLLLLLSSSSSSSSSS
SSSSSSSSLLLLLLLLLLLLLLSSSSSSSS
SSSSSSSLLLLLLLLLLLLLLLLSSSSSSS
SSSSSSLLLLLLLLLLLLLLLLLLSSSSSS
SSSSSLLLLLLLLLLLLLLLLLLLSSSSSS
SSSSSSLLLLLLLLLLLLLLLLLLSSSSSS
SSSSSSSLLLLLLLLLLLLLLLLSSSSSSS
SSSSSSSSLLLLLLLLLLLLLLSSSSSSSS
SSSSSSSSSSLLLLLLLLLLSSSSSSSSSS
SSSSSSSSSSSSSSSSSSSSSSSSSSSSSS
SSSSSSSSSSSSSSSSSSSSSSSSSSSSSS
SSSSSSSSSSLLLLLLLLLLSSSSSSSSSS
SSSSSSSSLLLLLLLLLLLLLLSSSSSSSS
SSSSSSSLLLLLLLLLLLLLLLLSSSSSSS
SSSSSSLLLLLLLLLLLLLLLLLLSSSSSS
SSSSSLLLLLLLLLLLLLLLLLLLSSSSSS
SSSSSSLLLLLLLLLLLLLLLLLLSSSSSS
SSSSSSSLLLLLLLLLLLLLLLLSSSSSSS
SSSSSSSSLLLLLLLLLLLLLLSSSSSSSS
SSSSSSSSSSLLLLLLLLLLSSSSSSSSSS
SSSSSSSSSSSSSSSSSSSSSSSSSSSSSS
SSSSSSSSSSSSSSSSSSSSSSSSSSSSSS
SSSSSSSSSSLLLLLLLLLLSSSSSSSSSS
SSSSSSSSLLLLLLLLLLLLLLSSSSSSSS
SSSSSSSLLLLLLLLLLLLLLLLSSSSSSS
SSSSSSLLLLLLLLLLLLLLLLLLSSSSSS
SSSSSLLLLLLLLLLLLLLLLLLLSSSSSS
SSSSSSLLLLLLLLLLLLLLLLLLSSSSSS
SSSSSSSLLLLLLLLLLLLLLLLSSSSSSS
SSSSSSSSLLLLLLLLLLLLLLSSSSSSSS
SSSSSSSSSSLLLLLLLLLLSSSSSSSSSS
SSSSSSSSSSSSSSSSSSSSSSSSSSSSSS